11111111111111111111111111111111111111111111
1E0000000000000C00000C0000000000000000100001
10100101001000001010010000000101010000000001
10100100101010100010010000000000010000C00001
1P0000000C00C0000000000000000000C10000000001
10000000010000000000000000000000000000000001
11111111111111111111111111111111111111111111