1111111111111111111111111111111111
1E0010000000000C01000C000000000001
1000101001000100010010000000101001
1000100101010101110010000000000001
10100000C00C00000000000000000000C1
1P00100000111110000001111100000C01
1000100000000000000000010000000001
1111111111111111111111111111111111