11111111111111111111111111111111111111111111
1E0000000100000C00100C00000000000000000000X1
10000000010011000010000000011100011111000001
10111100010000000010000011100010000000C01001
1P0000000C00C0000010000000000000C00000001001
10000000000000000000001110000000001110000001
11111111111111111111111111111111111111111111