1111111111111111111111111111111111
1E00100000000000010000000000000001
1000101001000100010010000000101001
1000100101010101110010000X00000001
1010000000000000000000000000000001
1P00100000111110000001111100000101
1000100000000000000000010000000C01
1111111111111111111111111111111111